ORIENT=RANDOM
SUBST=:=>FT_WINDOW
########
#......#
:......+
#......#
########
END
ORIENT=RANDOM
########
#......#
#..#...+
#..#...#
########
END
ORIENT=RANDOM
##########
#...#....#
#...+....+
#...#....#
##########
END
ORIENT=RANDOM

##########
#...#....#
#...+....+
#####....#
#...+....#
#...#....#
##########
END
SUBST=:=>FT_WINDOW
ORIENT=RANDOM
####:#####
#........#
#........+
#........#
####:#####
END